100 0 1 0 2 0 3 0 7
80 0 1 0 2 0 5 0 6 0 7 0 12 0 13 0 14 0 15 0 16 0 17 0 18 0 25 0 26 0 27 0 28
100 0 2 0 3 0 4 0 5 0 6 0 7 0 8 0 15 0 16 0 17 1 18 0 19 0 20 1 27
180 0 3 0 4 0 9 0 10 0 11 0 12 0 13 0 14 0 15 0 16 0 17 0 18 0 19 0 25 1 26 0 27 1 28 0 29
180 0 3 0 4 0 5 0 6 0 7 0 8 0 14 1 15 0 16 1 17 0 18 1 19 1 28 1 29 1 30 1 31 1 32 0 40 1 41 2 42 3 50 3 51 3 52 3 53 3 54 3 70 3 71 3 72 3 73 3 74 3 75 3 76 3 77 3 78